0 0 0 0 0 0 0 4 4 4 0 0 0 0 0 0 0 0 0 0 0 0 0 4 4 0 0 0 0 0 
0 1 0 1 1 1 1 1 1 0 0 0 0 0 0 1 0 0 0 0 0 0 0 0 0 1 0 0 0 0 
0 1 0 0 0 0 0 0 0 0 0 0 0 0 0 1 0 1 1 1 1 0 0 0 0 1 0 1 1 1 
0 1 0 0 0 1 0 0 1 0 0 0 0 0 0 1 0 0 110 0 0 120 0 0 0 1 0 1 0 0 
0 1 0 0 0 1 0 0 1 0 0 0 0 0 0 1 0 0 4 0 0 0 1 0 0 0 0 1 0 0 
0 1 0 1 1 1 0 0 0 0 210 0 0 1 1 1 1 1 1 0 0 1 0 1 0 0 0 1 0 0 
0 1 0 0 0 1 0 0 0 0 0 0 0 0 0 4 4 4 4 0 1 0 0 0 1 0 0 1 0 0 
0 1 0 0 4 1 0 0 0 0 0 0 0 0 0 0 4 4 0 1 0 0 230 0 0 1 0 1 0 0 
0 1 0 0 4 1 0 0 0 0 0 0 0 220 0 0 4 0 1 0 0 0 1 1 0 0 1 0 0 100 
0 1 0 0 0 1 0 1 1 1 1 1 0 0 0 0 0 0 0 0 130 1 0 0 1 0 280 0 0 0 
0 1 0 1 0 0 0 0 0 0 0 0 0 0 0 0 0 0 0 0 1 0 0 150 1 0 0 0 0 0 
0 1 0 0 0 0 0 0 0 0 0 140 4 0 0 0 0 0 0 0 0 0 0 0 1 0 0 0 0 0 
0 1 0 0 0 0 0 0 0 0 0 0 0 0 0 0 0 1 1 1 1 1 1 1 1 0 1 1 0 0 
0 1 0 1 1 1 1 1 0 160 0 0 4 0 0 0 0 1 4 0 0 0 0 0 0 0 4 1 0 0 
0 1 0 4 0 0 0 1 0 0 0 0 1 0 0 0 260 1 0 0 0 0 1 0 0 0 0 1 0 0 
0 1 0 4 0 0 0 1 0 0 0 0 1 4 0 0 0 1 0 0 0 0 1 0 0 0 0 1 0 0 
0 1 0 1 0 0 0 0 0 1 4 0 1 0 4 0 0 1 0 0 200 0 1 170 0 0 0 1 0 0 
0 1 0 1 0 0 0 190 0 1 4 0 1 0 4 1 0 1 0 1 1 1 1 1 1 1 0 1 0 0 
0 1 0 1 0 1 0 0 0 1 0 0 1 0 4 1 0 1 0 0 0 0 1 0 0 0 0 1 0 0 
0 1 0 1 0 1 0 240 0 1 0 0 1 0 0 1 0 1 0 0 0 0 1 0 0 0 0 1 0 0 
4 1 0 1 1 1 1 0 0 1 0 0 1 0 0 1 0 1 0 0 0 0 1 0 0 0 0 1 4 0 
4 1 0 1 0 0 0 0 0 0 4 4 0 180 0 0 0 1 4 0 0 0 0 0 0 0 4 1 0 0 
4 1 0 1 0 0 4 0 0 0 4 4 1 1 1 1 0 1 1 0 1 1 1 1 1 1 1 1 0 0 
0 1 0 1 0 1 4 4 0 1 0 0 0 0 0 0 0 0 0 0 0 290 0 0 0 0 0 0 0 0 
0 1 0 0 0 1 4 0 0 1 0 0 0 0 1 0 250 0 0 0 0 0 0 0 0 0 0 0 0 0 
0 1 0 0 0 1 0 0 270 1 0 0 0 0 1 0 0 1 0 0 0 0 0 0 1 1 0 0 0 0
0 1 0 0 0 1 1 1 0 1 4 0 1 1 1 1 0 0 1 0 0 0 0 1 0 0 1 0 0 0 
0 1 0 1 0 0 0 0 0 1 0 0 0 0 0 0 0 0 0 1 0 4 1 0 0 0 4 1 0 0 
0 1 0 1 0 0 0 0 0 0 0 0 0 4 4 0 0 0 0 0 1 1 0 0 1 1 0 0 1 0 
0 0 0 1 0 1 0 0 1 0 0 0 0 0 0 0 0 0 0 0 0 0 0 0 0 0 0 0 0 0 
